option	type	description
project.new.default_directory	string	home folder subdirectory which acts as the pre-defined directory where the "new project" file dialog starts. If it doesn't exist or the given path is invalid then the "new project" dialog defaults to the ~/ folder.
project.open.default_directory	string	directory where the program looks for the first time
viewport.node.radius	number	sets the default scale for the sphere depicting the nodes
viewport.node.color	number array	color
viewport.wireframe.color	number array	the default value for the wireframe color

analysis.quadrature.domain.tetrahedron4	number
analysis.quadrature.stiffness.tetrahedron4	number
analysis.quadrature.stiffness.tetrahedron10	number
analysis.quadrature.stiffness.hexahedron8	number
analysis.quadrature.stiffness.hexahedron20	number
analysis.quadrature.stiffness.hexahedron27	number
analysis.quadrature.stiffness.prism6	number
analysis.quadrature.stiffness.prism15	number
analysis.quadrature.stiffness.prism18	number

analysis.quadrature.domain.triangle3	number
analysis.quadrature.domain.triangle6	number
analysis.quadrature.domain.triangle10	number
analysis.quadrature.domain.quadrangle4	number
analysis.quadrature.domain.quadrangle8	number
analysis.quadrature.domain.quadrangle9	number
analysis.quadrature.domain.tetrahedron10	number
analysis.quadrature.domain.hexahedron8	number
analysis.quadrature.domain.hexahedron20	number
analysis.quadrature.domain.hexahedron27	number
analysis.quadrature.domain.prism6	number
analysis.quadrature.domain.prism15	number
analysis.quadrature.domain.prism18	number
